Date,Confirmed Cases,Probable Cases,Total Cases,Total Deaths,Total Tests,Date Updated
02/21/2020,0,0,0,0,8,06/01/2023
02/22/2020,0,0,0,0,1,06/01/2023
02/25/2020,0,0,0,0,1,06/01/2023
02/26/2020,0,0,0,0,3,06/01/2023
02/28/2020,0,0,0,0,3,06/01/2023
02/29/2020,0,0,0,0,1,06/01/2023
03/01/2020,0,0,0,0,18,06/01/2023
03/02/2020,0,1,1,0,4,06/01/2023
03/03/2020,0,0,0,0,12,06/01/2023
03/04/2020,0,0,0,0,12,06/01/2023
03/05/2020,0,2,2,0,15,06/01/2023
03/06/2020,1,1,2,0,13,06/01/2023
03/07/2020,0,4,4,0,23,06/01/2023
03/08/2020,1,6,7,0,35,06/01/2023
03/09/2020,3,5,8,0,46,06/01/2023
03/10/2020,6,3,9,0,27,06/01/2023
03/11/2020,10,4,14,0,62,06/01/2023
03/12/2020,43,6,49,0,98,06/01/2023
03/13/2020,25,3,28,0,143,06/01/2023
03/14/2020,26,3,29,0,124,06/01/2023
03/15/2020,24,4,28,0,136,06/01/2023
03/16/2020,123,3,126,0,571,06/01/2023
03/17/2020,146,3,149,1,991,06/01/2023
03/18/2020,211,12,223,2,1346,06/01/2023
03/19/2020,256,5,261,1,1525,06/01/2023
03/20/2020,260,7,267,2,1684,06/01/2023
03/21/2020,189,4,193,5,974,06/01/2023
03/22/2020,148,7,155,5,694,06/01/2023
03/23/2020,417,12,429,4,1803,06/01/2023
03/24/2020,465,7,472,6,2047,06/01/2023
03/25/2020,474,5,479,9,1957,06/01/2023
03/26/2020,650,13,663,5,2265,06/01/2023
03/27/2020,641,9,650,6,2222,06/01/2023
03/28/2020,453,6,459,15,1333,06/01/2023
03/29/2020,336,8,344,15,832,06/01/2023
03/30/2020,840,20,860,25,2138,06/01/2023
03/31/2020,874,11,885,24,2237,06/01/2023
04/01/2020,909,23,932,24,2491,06/01/2023
04/02/2020,878,20,898,38,2406,06/01/2023
04/03/2020,821,17,838,31,2444,06/01/2023
04/04/2020,656,17,673,54,1712,06/01/2023
04/05/2020,437,12,449,53,1158,06/01/2023
04/06/2020,1030,42,1072,60,2803,06/01/2023
04/07/2020,1111,34,1145,85,2878,06/01/2023
04/08/2020,1127,21,1148,78,3015,06/01/2023
04/09/2020,961,26,987,92,2578,06/01/2023
04/10/2020,1069,22,1091,65,2807,06/01/2023
04/11/2020,626,8,634,89,1809,06/01/2023
04/12/2020,347,19,366,86,1055,06/01/2023
04/13/2020,644,24,668,95,1606,06/01/2023
04/14/2020,1185,49,1234,96,3674,06/01/2023
04/15/2020,1041,46,1087,99,3129,06/01/2023
04/16/2020,943,32,975,104,3190,06/01/2023
04/17/2020,969,35,1004,96,3718,06/01/2023
04/18/2020,490,33,523,106,2238,06/01/2023
04/19/2020,345,19,364,93,1612,06/01/2023
04/20/2020,1002,23,1025,103,3531,06/01/2023
04/21/2020,797,52,849,116,3054,06/01/2023
04/22/2020,883,34,917,89,4033,06/01/2023
04/23/2020,824,50,874,96,4079,06/01/2023
04/24/2020,746,32,778,100,4340,06/01/2023
04/25/2020,487,19,506,90,2495,06/01/2023
04/26/2020,325,12,337,84,1892,06/01/2023
04/27/2020,814,45,859,83,4422,06/01/2023
04/28/2020,694,27,721,87,3866,06/01/2023
04/29/2020,796,35,831,73,4725,06/01/2023
04/30/2020,619,39,658,82,3578,06/01/2023
05/01/2020,700,24,724,80,4051,06/01/2023
05/02/2020,430,24,454,85,3204,06/01/2023
05/03/2020,338,25,363,80,2351,06/01/2023
05/04/2020,638,24,662,77,4383,06/01/2023
05/05/2020,667,39,706,64,4850,06/01/2023
05/06/2020,501,30,531,65,4297,06/01/2023
05/07/2020,554,38,592,72,4549,06/01/2023
05/08/2020,554,34,588,53,6099,06/01/2023
05/09/2020,219,12,231,55,2913,06/01/2023
05/10/2020,198,5,203,63,2289,06/01/2023
05/11/2020,607,29,636,56,6171,06/01/2023
05/12/2020,581,35,616,60,8216,06/01/2023
05/13/2020,692,40,732,53,7658,06/01/2023
05/14/2020,490,39,529,51,7746,06/01/2023
05/15/2020,441,26,467,52,7596,06/01/2023
05/16/2020,191,18,209,49,3727,06/01/2023
05/17/2020,146,9,155,50,2693,06/01/2023
05/18/2020,468,17,485,44,6883,06/01/2023
05/19/2020,613,22,635,46,6964,06/01/2023
05/20/2020,495,35,530,41,7130,06/01/2023
05/21/2020,369,29,398,40,7360,06/01/2023
05/22/2020,301,24,325,31,7254,06/01/2023
05/23/2020,135,12,147,31,3421,06/01/2023
05/24/2020,106,3,109,43,2579,06/01/2023
05/25/2020,84,4,88,22,2269,06/01/2023
05/26/2020,359,40,399,31,9017,06/01/2023
05/27/2020,396,32,428,29,8596,06/01/2023
05/28/2020,251,22,273,31,8352,06/01/2023
05/29/2020,201,14,215,29,7460,06/01/2023
05/30/2020,114,11,125,26,3747,06/01/2023
05/31/2020,75,13,88,20,2504,06/01/2023
06/01/2020,286,18,304,20,8245,06/01/2023
06/02/2020,274,15,289,14,7570,06/01/2023
06/03/2020,192,12,204,16,7614,06/01/2023
06/04/2020,203,14,217,18,8320,06/01/2023
06/05/2020,145,15,160,16,8077,06/01/2023
06/06/2020,75,2,77,17,3611,06/01/2023
06/07/2020,40,4,44,16,2437,06/01/2023
06/08/2020,241,11,252,12,8818,06/01/2023
06/09/2020,193,13,206,16,8441,06/01/2023
06/10/2020,280,19,299,13,9447,06/01/2023
06/11/2020,125,12,137,10,7311,06/01/2023
06/12/2020,80,5,85,11,6548,06/01/2023
06/13/2020,50,3,53,9,3025,06/01/2023
06/14/2020,36,4,40,5,2410,06/01/2023
06/15/2020,117,7,124,10,8987,06/01/2023
06/16/2020,92,15,107,10,9899,06/01/2023
06/17/2020,116,8,124,5,10226,06/01/2023
06/18/2020,91,10,101,7,8896,06/01/2023
06/19/2020,77,11,88,6,6648,06/01/2023
06/20/2020,65,6,71,3,4349,06/01/2023
06/21/2020,35,5,40,9,3179,06/01/2023
06/22/2020,96,26,122,10,12077,06/01/2023
06/23/2020,107,15,122,6,12047,06/01/2023
06/24/2020,101,8,109,5,13580,06/01/2023
06/25/2020,98,11,109,4,13917,06/01/2023
06/26/2020,82,8,90,4,11458,06/01/2023
06/27/2020,43,2,45,6,5441,06/01/2023
06/28/2020,36,3,39,5,3864,06/01/2023
06/29/2020,107,18,125,2,13301,06/01/2023
06/30/2020,143,13,156,3,15045,06/01/2023
07/01/2020,136,12,148,6,13917,06/01/2023
07/02/2020,120,7,127,3,14155,06/01/2023
07/03/2020,53,2,55,4,5842,06/01/2023
07/04/2020,27,0,27,2,2165,06/01/2023
07/05/2020,42,6,48,1,4369,06/01/2023
07/06/2020,108,8,116,6,15245,06/01/2023
07/07/2020,122,2,124,3,14579,06/01/2023
07/08/2020,100,9,109,2,15125,06/01/2023
07/09/2020,94,7,101,5,12732,06/01/2023
07/10/2020,78,8,86,2,12311,06/01/2023
07/11/2020,44,10,54,6,5153,06/01/2023
07/12/2020,35,2,37,5,4275,06/01/2023
07/13/2020,103,8,111,4,14466,06/01/2023
07/14/2020,105,4,109,2,15899,06/01/2023
07/15/2020,102,8,110,2,14469,06/01/2023
07/16/2020,99,7,106,2,13311,06/01/2023
07/17/2020,59,9,68,0,12997,06/01/2023
07/18/2020,49,0,49,1,4024,06/01/2023
07/19/2020,31,4,35,3,6118,06/01/2023
07/20/2020,90,16,106,2,13100,06/01/2023
07/21/2020,109,9,118,1,13825,06/01/2023
07/22/2020,83,7,90,2,14357,06/01/2023
07/23/2020,146,9,155,4,15554,06/01/2023
07/24/2020,116,2,118,0,12273,06/01/2023
07/25/2020,51,6,57,2,5432,06/01/2023
07/26/2020,28,6,34,2,7282,06/01/2023
07/27/2020,116,6,122,0,13523,06/01/2023
07/28/2020,79,8,87,1,14442,06/01/2023
07/29/2020,91,7,98,0,15291,06/01/2023
07/30/2020,93,7,100,5,14577,06/01/2023
07/31/2020,67,8,75,0,11715,06/01/2023
08/01/2020,37,6,43,2,5463,06/01/2023
08/02/2020,30,4,34,1,7378,06/01/2023
08/03/2020,97,8,105,1,12932,06/01/2023
08/04/2020,80,6,86,1,12499,06/01/2023
08/05/2020,90,4,94,1,13403,06/01/2023
08/06/2020,105,11,116,1,15198,06/01/2023
08/07/2020,68,16,84,2,11780,06/01/2023
08/08/2020,36,5,41,2,5464,06/01/2023
08/09/2020,28,5,33,2,6512,06/01/2023
08/10/2020,83,12,95,3,16395,06/01/2023
08/11/2020,102,10,112,1,15518,06/01/2023
08/12/2020,93,11,104,1,16612,06/01/2023
08/13/2020,115,4,119,0,16047,06/01/2023
08/14/2020,130,17,147,1,14800,06/01/2023
08/15/2020,44,10,54,0,7511,06/01/2023
08/16/2020,45,12,57,0,9224,06/01/2023
08/17/2020,161,14,175,0,19550,06/01/2023
08/18/2020,151,12,163,0,17045,06/01/2023
08/19/2020,137,12,149,3,17857,06/01/2023
08/20/2020,124,12,136,0,17915,06/01/2023
08/21/2020,96,11,107,1,14585,06/01/2023
08/22/2020,78,12,90,0,6793,06/01/2023
08/23/2020,48,1,49,1,5852,06/01/2023
08/24/2020,175,11,186,1,20056,06/01/2023
08/25/2020,160,10,170,1,20887,06/01/2023
08/26/2020,138,13,151,0,20626,06/01/2023
08/27/2020,123,11,134,0,19332,06/01/2023
08/28/2020,168,4,172,1,18163,06/01/2023
08/29/2020,83,3,86,2,8202,06/01/2023
08/30/2020,48,2,50,1,8414,06/01/2023
08/31/2020,161,14,175,2,20518,06/01/2023
09/01/2020,154,10,164,0,20555,06/01/2023
09/02/2020,168,14,182,1,20073,06/01/2023
09/03/2020,157,10,167,2,22054,06/01/2023
09/04/2020,103,9,112,2,16150,06/01/2023
09/05/2020,90,8,98,0,7039,06/01/2023
09/06/2020,67,9,76,0,5568,06/01/2023
09/07/2020,73,8,81,1,9303,06/01/2023
09/08/2020,224,14,238,0,27911,06/01/2023
09/09/2020,203,17,220,2,27455,06/01/2023
09/10/2020,156,10,166,1,21686,06/01/2023
09/11/2020,178,4,182,2,17436,06/01/2023
09/12/2020,120,7,127,2,8015,06/01/2023
09/13/2020,72,7,79,1,7385,06/01/2023
09/14/2020,233,16,249,2,23702,06/01/2023
09/15/2020,154,8,162,1,25029,06/01/2023
09/16/2020,164,22,186,2,23210,06/01/2023
09/17/2020,185,10,195,2,21930,06/01/2023
09/18/2020,166,35,201,1,19391,06/01/2023
09/19/2020,117,16,133,3,8188,06/01/2023
09/20/2020,71,15,86,2,8102,06/01/2023
09/21/2020,193,29,222,1,25609,06/01/2023
09/22/2020,212,40,252,1,29088,06/01/2023
09/23/2020,206,26,232,1,25098,06/01/2023
09/24/2020,197,25,222,1,24199,06/01/2023
09/25/2020,239,21,260,2,19388,06/01/2023
09/26/2020,164,15,179,0,7959,06/01/2023
09/27/2020,99,19,118,4,5762,06/01/2023
09/28/2020,321,28,349,2,29236,06/01/2023
09/29/2020,355,34,389,3,30882,06/01/2023
09/30/2020,317,20,337,2,26849,06/01/2023
10/01/2020,279,12,291,2,27136,06/01/2023
10/02/2020,353,6,359,3,23509,06/01/2023
10/03/2020,163,8,171,0,9880,06/01/2023
10/04/2020,125,5,130,4,7879,06/01/2023
10/05/2020,358,32,390,3,35770,06/01/2023
10/06/2020,390,47,437,2,40688,06/01/2023
10/07/2020,522,23,545,1,32698,06/01/2023
10/08/2020,402,43,445,2,29342,06/01/2023
10/09/2020,390,26,416,2,25361,06/01/2023
10/10/2020,201,20,221,3,10467,06/01/2023
10/11/2020,148,31,179,1,8394,06/01/2023
10/12/2020,415,19,434,3,28238,06/01/2023
10/13/2020,484,41,525,3,29438,06/01/2023
10/14/2020,462,48,510,5,29532,06/01/2023
10/15/2020,486,48,534,8,27953,06/01/2023
10/16/2020,465,36,501,8,25133,06/01/2023
10/17/2020,321,46,367,4,10735,06/01/2023
10/18/2020,260,234,494,4,10857,06/01/2023
10/19/2020,692,28,720,5,37772,06/01/2023
10/20/2020,662,23,685,2,39044,06/01/2023
10/21/2020,717,23,740,8,32118,06/01/2023
10/22/2020,687,22,709,7,33461,06/01/2023
10/23/2020,709,72,781,5,26451,06/01/2023
10/24/2020,452,32,484,1,11547,06/01/2023
10/25/2020,382,39,421,10,10507,06/01/2023
10/26/2020,928,80,1008,12,39920,06/01/2023
10/27/2020,957,86,1043,6,45877,06/01/2023
10/28/2020,1012,55,1067,7,39372,06/01/2023
10/29/2020,916,67,983,10,33851,06/01/2023
10/30/2020,873,62,935,5,26625,06/01/2023
10/31/2020,550,38,588,13,12030,06/01/2023
11/01/2020,487,48,535,4,11420,06/01/2023
11/02/2020,1366,49,1415,10,42935,06/01/2023
11/03/2020,1138,51,1189,11,41030,06/01/2023
11/04/2020,1657,59,1716,7,40364,06/01/2023
11/05/2020,1769,65,1834,12,40898,06/01/2023
11/06/2020,1788,118,1906,11,37509,06/01/2023
11/07/2020,1112,75,1187,13,16545,06/01/2023
11/08/2020,915,87,1002,9,14257,06/01/2023
11/09/2020,2254,168,2422,11,48642,06/01/2023
11/10/2020,2174,166,2340,8,49674,06/01/2023
11/11/2020,2090,131,2221,12,44199,06/01/2023
11/12/2020,2034,112,2146,9,43162,06/01/2023
11/13/2020,2101,153,2254,15,40776,06/01/2023
11/14/2020,1355,79,1434,16,19611,06/01/2023
11/15/2020,911,47,958,19,17381,06/01/2023
11/16/2020,2328,163,2491,18,52514,06/01/2023
11/17/2020,2203,137,2340,19,49074,06/01/2023
11/18/2020,2118,108,2226,19,50536,06/01/2023
11/19/2020,1988,107,2095,15,45235,06/01/2023
11/20/2020,1917,98,2015,28,44163,06/01/2023
11/21/2020,1313,62,1375,12,22156,06/01/2023
11/22/2020,1064,55,1119,22,20418,06/01/2023
11/23/2020,2273,122,2395,23,56009,06/01/2023
11/24/2020,2224,89,2313,28,55088,06/01/2023
11/25/2020,2136,103,2239,24,42501,06/01/2023
11/26/2020,293,40,333,29,4652,06/01/2023
11/27/2020,2034,120,2154,25,32395,06/01/2023
11/28/2020,1551,63,1614,15,18452,06/01/2023
11/29/2020,1101,52,1153,30,15070,06/01/2023
11/30/2020,2549,144,2693,29,42841,06/01/2023
12/01/2020,3046,155,3201,29,46182,06/01/2023
12/02/2020,2945,141,3086,34,44650,06/01/2023
12/03/2020,2602,176,2778,31,41337,06/01/2023
12/04/2020,2436,125,2561,30,33954,06/01/2023
12/05/2020,1371,107,1478,38,17423,06/01/2023
12/06/2020,1193,95,1288,28,17205,06/01/2023
12/07/2020,2632,180,2812,30,43911,06/01/2023
12/08/2020,2411,194,2605,36,44118,06/01/2023
12/09/2020,2293,132,2425,38,45668,06/01/2023
12/10/2020,2219,151,2370,23,41458,06/01/2023
12/11/2020,2204,132,2336,35,36790,06/01/2023
12/12/2020,1454,77,1531,35,19414,06/01/2023
12/13/2020,1154,58,1212,37,16761,06/01/2023
12/14/2020,2604,172,2776,36,49626,06/01/2023
12/15/2020,2368,160,2528,36,45875,06/01/2023
12/16/2020,1982,153,2135,30,41518,06/01/2023
12/17/2020,388,59,447,36,11404,06/01/2023
12/18/2020,2190,139,2329,43,36726,06/01/2023
12/19/2020,1392,90,1482,39,19053,06/01/2023
12/20/2020,1048,70,1118,38,18797,06/01/2023
12/21/2020,2548,179,2727,36,52114,06/01/2023
12/22/2020,2278,148,2426,27,51494,06/01/2023
12/23/2020,2139,111,2250,28,44385,06/01/2023
12/24/2020,1577,57,1634,50,23516,06/01/2023
12/25/2020,256,20,276,33,3946,06/01/2023
12/26/2020,1726,100,1826,34,19579,06/01/2023
12/27/2020,1434,80,1514,52,18404,06/01/2023
12/28/2020,3148,150,3298,31,51158,06/01/2023
12/29/2020,2996,107,3103,43,49223,06/01/2023
12/30/2020,2831,89,2920,45,46353,06/01/2023
12/31/2020,2262,67,2329,49,31648,06/01/2023
01/01/2021,501,76,577,33,7145,06/01/2023
01/02/2021,2082,125,2207,45,24538,06/01/2023
01/03/2021,1600,112,1712,24,21075,06/01/2023
01/04/2021,3316,225,3541,41,56745,06/01/2023
01/05/2021,3303,119,3422,38,51326,06/01/2023
01/06/2021,2983,126,3109,30,49320,06/01/2023
01/07/2021,2656,217,2873,30,44669,06/01/2023
01/08/2021,2438,198,2636,37,36690,06/01/2023
01/09/2021,1704,93,1797,41,21988,06/01/2023
01/10/2021,1193,113,1306,32,18386,06/01/2023
01/11/2021,2707,196,2903,33,55680,06/01/2023
01/12/2021,2333,180,2513,34,51651,06/01/2023
01/13/2021,2192,163,2355,40,50133,06/01/2023
01/14/2021,2155,166,2321,35,42782,06/01/2023
01/15/2021,1939,132,2071,31,37552,06/01/2023
01/16/2021,1253,116,1369,37,21481,06/01/2023
01/17/2021,1127,120,1247,27,21170,06/01/2023
01/18/2021,1831,151,1982,46,46737,06/01/2023
01/19/2021,2003,204,2207,49,53731,06/01/2023
01/20/2021,1945,157,2102,38,49168,06/01/2023
01/21/2021,1889,117,2006,29,46022,06/01/2023
01/22/2021,1793,136,1929,35,38603,06/01/2023
01/23/2021,1174,87,1261,33,21483,06/01/2023
01/24/2021,931,93,1024,32,20759,06/01/2023
01/25/2021,1859,118,1977,23,58952,06/01/2023
01/26/2021,1591,140,1731,24,50009,06/01/2023
01/27/2021,1550,143,1693,24,45509,06/01/2023
01/28/2021,1526,91,1617,22,42736,06/01/2023
01/29/2021,1252,106,1358,28,34404,06/01/2023
01/30/2021,907,98,1005,24,20654,06/01/2023
01/31/2021,853,78,931,22,19704,06/01/2023
02/01/2021,333,26,359,27,16372,06/01/2023
02/02/2021,1187,139,1326,28,38899,06/01/2023
02/03/2021,1654,122,1776,33,55981,06/01/2023
02/04/2021,1320,139,1459,24,46788,06/01/2023
02/05/2021,1079,97,1176,21,35328,06/01/2023
02/06/2021,783,74,857,17,18120,06/01/2023
02/07/2021,379,58,437,18,11648,06/01/2023
02/08/2021,1218,143,1361,16,50684,06/01/2023
02/09/2021,827,111,938,28,43771,06/01/2023
02/10/2021,1059,94,1153,22,46529,06/01/2023
02/11/2021,907,102,1009,22,39868,06/01/2023
02/12/2021,835,65,900,21,30741,06/01/2023
02/13/2021,564,87,651,18,16053,06/01/2023
02/14/2021,409,66,475,15,14454,06/01/2023
02/15/2021,818,88,906,14,41684,06/01/2023
02/16/2021,792,81,873,11,44514,06/01/2023
02/17/2021,911,82,993,13,45815,06/01/2023
02/18/2021,563,84,647,7,28497,06/01/2023
02/19/2021,709,89,798,13,28428,06/01/2023
02/20/2021,537,68,605,12,16228,06/01/2023
02/21/2021,442,50,492,13,16173,06/01/2023
02/22/2021,938,122,1060,9,52052,06/01/2023
02/23/2021,927,129,1056,10,50646,06/01/2023
02/24/2021,757,127,884,18,45097,06/01/2023
02/25/2021,842,120,962,11,37469,06/01/2023
02/26/2021,537,104,641,10,27676,06/01/2023
02/27/2021,508,72,580,9,13722,06/01/2023
02/28/2021,409,73,482,8,13830,06/01/2023
03/01/2021,688,111,799,19,43090,06/01/2023
03/02/2021,735,120,855,3,43156,06/01/2023
03/03/2021,825,130,955,6,40139,06/01/2023
03/04/2021,760,109,869,11,34518,06/01/2023
03/05/2021,754,88,842,8,30289,06/01/2023
03/06/2021,448,91,539,8,14302,06/01/2023
03/07/2021,510,85,595,10,14653,06/01/2023
03/08/2021,939,122,1061,9,44354,06/01/2023
03/09/2021,832,134,966,7,35648,06/01/2023
03/10/2021,880,121,1001,8,39157,06/01/2023
03/11/2021,889,141,1030,9,35990,06/01/2023
03/12/2021,880,148,1028,7,30433,06/01/2023
03/13/2021,561,98,659,10,13850,06/01/2023
03/14/2021,478,105,583,5,13617,06/01/2023
03/15/2021,1004,165,1169,11,41933,06/01/2023
03/16/2021,979,143,1122,9,44227,06/01/2023
03/17/2021,1111,108,1219,7,40808,06/01/2023
03/18/2021,1055,183,1238,6,36861,06/01/2023
03/19/2021,1020,134,1154,7,32718,06/01/2023
03/20/2021,776,124,900,5,16487,06/01/2023
03/21/2021,643,78,721,6,14866,06/01/2023
03/22/2021,1328,203,1531,13,47449,06/01/2023
03/23/2021,1205,206,1411,5,52092,06/01/2023
03/24/2021,1365,133,1498,5,44643,06/01/2023
03/25/2021,1223,228,1451,8,42980,06/01/2023
03/26/2021,1245,372,1617,2,38222,06/01/2023
03/27/2021,809,141,950,6,15981,06/01/2023
03/28/2021,697,132,829,6,16205,06/01/2023
03/29/2021,1469,147,1616,8,47866,06/01/2023
03/30/2021,1238,203,1441,7,43397,06/01/2023
03/31/2021,1423,165,1588,5,42097,06/01/2023
04/01/2021,1066,185,1251,5,35062,06/01/2023
04/02/2021,1001,127,1128,7,30189,06/01/2023
04/03/2021,758,69,827,8,16217,06/01/2023
04/04/2021,386,44,430,4,8436,06/01/2023
04/05/2021,1304,226,1530,5,49702,06/01/2023
04/06/2021,1145,221,1366,4,48220,06/01/2023
04/07/2021,1226,97,1323,8,45949,06/01/2023
04/08/2021,991,212,1203,9,39120,06/01/2023
04/09/2021,995,133,1128,4,31456,06/01/2023
04/10/2021,644,95,739,4,14611,06/01/2023
04/11/2021,587,101,688,7,13644,06/01/2023
04/12/2021,1268,194,1462,5,50800,06/01/2023
04/13/2021,960,101,1061,4,40198,06/01/2023
04/14/2021,978,156,1134,4,38725,06/01/2023
04/15/2021,796,173,969,8,34709,06/01/2023
04/16/2021,790,99,889,5,32485,06/01/2023
04/17/2021,670,80,750,10,18207,06/01/2023
04/18/2021,444,57,501,7,16615,06/01/2023
04/19/2021,869,129,998,6,46419,06/01/2023
04/20/2021,814,164,978,5,44868,06/01/2023
04/21/2021,803,130,933,4,36693,06/01/2023
04/22/2021,715,142,857,9,33686,06/01/2023
04/23/2021,595,79,674,10,28937,06/01/2023
04/24/2021,356,76,432,8,12944,06/01/2023
04/25/2021,287,48,335,9,10522,06/01/2023
04/26/2021,683,156,839,9,41948,06/01/2023
04/27/2021,560,72,632,4,39005,06/01/2023
04/28/2021,533,98,631,6,36482,06/01/2023
04/29/2021,422,122,544,4,32087,06/01/2023
04/30/2021,430,83,513,6,26087,06/01/2023
05/01/2021,265,54,319,9,10552,06/01/2023
05/02/2021,203,106,309,6,10863,06/01/2023
05/03/2021,449,87,536,6,38353,06/01/2023
05/04/2021,343,69,412,6,34229,06/01/2023
05/05/2021,313,79,392,4,29773,06/01/2023
05/06/2021,249,65,314,7,24749,06/01/2023
05/07/2021,298,35,333,4,22846,06/01/2023
05/08/2021,201,42,243,6,10208,06/01/2023
05/09/2021,142,37,179,4,7805,06/01/2023
05/10/2021,314,72,386,5,32086,06/01/2023
05/11/2021,278,53,331,3,30327,06/01/2023
05/12/2021,250,47,297,6,25271,06/01/2023
05/13/2021,240,33,273,2,21698,06/01/2023
05/14/2021,212,33,245,8,18333,06/01/2023
05/15/2021,114,5,119,7,8110,06/01/2023
05/16/2021,115,12,127,3,7573,06/01/2023
05/17/2021,217,55,272,3,27085,06/01/2023
05/18/2021,189,43,232,4,24920,06/01/2023
05/19/2021,149,39,188,2,22200,06/01/2023
05/20/2021,151,23,174,3,18192,06/01/2023
05/21/2021,125,33,158,2,16098,06/01/2023
05/22/2021,105,27,132,1,7560,06/01/2023
05/23/2021,61,27,88,1,7047,06/01/2023
05/24/2021,139,23,162,8,22626,06/01/2023
05/25/2021,122,24,146,0,19671,06/01/2023
05/26/2021,113,20,133,3,18116,06/01/2023
05/27/2021,92,25,117,1,14167,06/01/2023
05/28/2021,73,22,95,1,11627,06/01/2023
05/29/2021,41,14,55,3,6724,06/01/2023
05/30/2021,32,15,47,1,5949,06/01/2023
05/31/2021,42,8,50,1,5725,06/01/2023
06/01/2021,95,30,125,1,23890,06/01/2023
06/02/2021,64,9,73,2,18095,06/01/2023
06/03/2021,97,17,114,2,14068,06/01/2023
06/04/2021,70,12,82,1,12795,06/01/2023
06/05/2021,40,10,50,2,6374,06/01/2023
06/06/2021,33,15,48,3,5590,06/01/2023
06/07/2021,61,24,85,1,16405,06/01/2023
06/08/2021,44,13,57,3,14902,06/01/2023
06/09/2021,44,7,51,2,14516,06/01/2023
06/10/2021,45,15,60,0,12586,06/01/2023
06/11/2021,38,9,47,0,10874,06/01/2023
06/12/2021,27,10,37,1,6278,06/01/2023
06/13/2021,28,7,35,0,5567,06/01/2023
06/14/2021,39,12,51,1,14749,06/01/2023
06/15/2021,46,13,59,0,13865,06/01/2023
06/16/2021,36,12,48,0,12166,06/01/2023
06/17/2021,44,12,56,0,11807,06/01/2023
06/18/2021,40,14,54,2,11060,06/01/2023
06/19/2021,24,11,35,0,6271,06/01/2023
06/20/2021,22,14,36,1,5298,06/01/2023
06/21/2021,33,12,45,0,14401,06/01/2023
06/22/2021,31,11,42,0,13609,06/01/2023
06/23/2021,39,15,54,1,12937,06/01/2023
06/24/2021,29,14,43,0,12332,06/01/2023
06/25/2021,45,4,49,1,10336,06/01/2023
06/26/2021,31,7,38,1,6100,06/01/2023
06/27/2021,20,10,30,0,5396,06/01/2023
06/28/2021,46,15,61,0,13272,06/01/2023
06/29/2021,42,19,61,0,12045,06/01/2023
06/30/2021,54,22,76,0,11611,06/01/2023
07/01/2021,43,9,52,0,9146,06/01/2023
07/02/2021,50,12,62,1,9046,06/01/2023
07/03/2021,34,13,47,2,5837,06/01/2023
07/04/2021,22,6,28,0,3013,06/01/2023
07/05/2021,63,23,86,0,7767,06/01/2023
07/06/2021,56,15,71,1,12007,06/01/2023
07/07/2021,82,23,105,2,11265,06/01/2023
07/08/2021,53,24,77,0,10417,06/01/2023
07/09/2021,58,23,81,0,9896,06/01/2023
07/10/2021,59,19,78,1,5879,06/01/2023
07/11/2021,62,19,81,2,5102,06/01/2023
07/12/2021,101,73,174,1,12187,06/01/2023
07/13/2021,78,39,117,1,10667,06/01/2023
07/14/2021,122,38,160,0,11700,06/01/2023
07/15/2021,135,26,161,1,10564,06/01/2023
07/16/2021,133,40,173,0,11102,06/01/2023
07/17/2021,111,25,136,0,6525,06/01/2023
07/18/2021,104,38,142,0,6392,06/01/2023
07/19/2021,228,56,284,3,14006,06/01/2023
07/20/2021,208,50,258,1,13505,06/01/2023
07/21/2021,233,70,303,0,13986,06/01/2023
07/22/2021,239,90,329,0,14248,06/01/2023
07/23/2021,204,62,266,2,12580,06/01/2023
07/24/2021,193,39,232,0,7256,06/01/2023
07/25/2021,188,52,240,2,7371,06/01/2023
07/26/2021,352,105,457,0,17058,06/01/2023
07/27/2021,302,99,401,0,16323,06/01/2023
07/28/2021,391,93,484,1,16092,06/01/2023
07/29/2021,386,87,473,0,15761,06/01/2023
07/30/2021,388,75,463,1,15349,06/01/2023
07/31/2021,319,54,373,1,9928,06/01/2023
08/01/2021,285,70,355,1,9307,06/01/2023
08/02/2021,542,111,653,0,20594,06/01/2023
08/03/2021,537,110,647,2,20880,06/01/2023
08/04/2021,524,100,624,0,20924,06/01/2023
08/05/2021,506,122,628,3,20945,06/01/2023
08/06/2021,486,73,559,0,17889,06/01/2023
08/07/2021,371,47,418,5,10993,06/01/2023
08/08/2021,303,21,324,2,8366,06/01/2023
08/09/2021,712,115,827,3,24244,06/01/2023
08/10/2021,593,143,736,3,23339,06/01/2023
08/11/2021,609,113,722,5,21368,06/01/2023
08/12/2021,556,117,673,5,20250,06/01/2023
08/13/2021,558,111,669,3,19428,06/01/2023
08/14/2021,422,86,508,10,11804,06/01/2023
08/15/2021,331,69,400,0,9728,06/01/2023
08/16/2021,705,122,827,4,22948,06/01/2023
08/17/2021,547,118,665,5,23907,06/01/2023
08/18/2021,602,117,719,4,22678,06/01/2023
08/19/2021,627,111,738,4,21304,06/01/2023
08/20/2021,585,117,702,3,20647,06/01/2023
08/21/2021,414,44,458,2,10268,06/01/2023
08/22/2021,227,42,269,5,5758,06/01/2023
08/23/2021,682,191,873,4,26207,06/01/2023
08/24/2021,800,109,909,8,27321,06/01/2023
08/25/2021,700,120,820,2,23598,06/01/2023
08/26/2021,659,106,765,8,22027,06/01/2023
08/27/2021,561,108,669,1,20879,06/01/2023
08/28/2021,439,74,513,6,12240,06/01/2023
08/29/2021,391,68,459,9,11324,06/01/2023
08/30/2021,687,147,834,8,28403,06/01/2023
08/31/2021,616,116,732,7,27068,06/01/2023
09/01/2021,595,86,681,3,24247,06/01/2023
09/02/2021,532,93,625,6,22731,06/01/2023
09/03/2021,444,78,522,8,21883,06/01/2023
09/04/2021,342,42,384,6,12630,06/01/2023
09/05/2021,377,73,450,7,11209,06/01/2023
09/06/2021,325,74,399,3,12452,06/01/2023
09/07/2021,737,108,845,8,35608,06/01/2023
09/08/2021,711,123,834,6,29973,06/01/2023
09/09/2021,717,116,833,6,28487,06/01/2023
09/10/2021,700,86,786,7,27617,06/01/2023
09/11/2021,433,52,485,3,11882,06/01/2023
09/12/2021,290,56,346,7,10003,06/01/2023
09/13/2021,724,105,829,6,26162,06/01/2023
09/14/2021,628,105,733,4,26869,06/01/2023
09/15/2021,567,108,675,10,27967,06/01/2023
09/16/2021,538,98,636,6,28697,06/01/2023
09/17/2021,572,91,663,4,26604,06/01/2023
09/18/2021,346,52,398,7,12433,06/01/2023
09/19/2021,247,58,305,6,10587,06/01/2023
09/20/2021,599,77,676,7,34290,06/01/2023
09/21/2021,561,99,660,7,32212,06/01/2023
09/22/2021,552,91,643,5,29019,06/01/2023
09/23/2021,563,76,639,7,29927,06/01/2023
09/24/2021,444,79,523,9,26536,06/01/2023
09/25/2021,267,36,303,4,12920,06/01/2023
09/26/2021,267,43,310,7,11821,06/01/2023
09/27/2021,475,77,552,5,33960,06/01/2023
09/28/2021,438,58,496,5,26281,06/01/2023
09/29/2021,386,53,439,5,28816,06/01/2023
09/30/2021,507,59,566,4,29341,06/01/2023
10/01/2021,424,81,505,6,27573,06/01/2023
10/02/2021,279,45,324,7,13877,06/01/2023
10/03/2021,240,46,286,4,12127,06/01/2023
10/04/2021,540,61,601,3,34245,06/01/2023
10/05/2021,442,61,503,4,33989,06/01/2023
10/06/2021,412,73,485,5,29380,06/01/2023
10/07/2021,478,58,536,4,28951,06/01/2023
10/08/2021,401,54,455,9,25487,06/01/2023
10/09/2021,293,41,334,6,13695,06/01/2023
10/10/2021,228,43,271,7,10306,06/01/2023
10/11/2021,465,58,523,4,26003,06/01/2023
10/12/2021,485,85,570,6,31930,06/01/2023
10/13/2021,509,69,578,6,29952,06/01/2023
10/14/2021,503,75,578,0,29874,06/01/2023
10/15/2021,366,59,425,4,25218,06/01/2023
10/16/2021,280,59,339,6,13195,06/01/2023
10/17/2021,218,41,259,5,10612,06/01/2023
10/18/2021,497,72,569,5,30955,06/01/2023
10/19/2021,416,64,480,8,30048,06/01/2023
10/20/2021,392,67,459,5,25314,06/01/2023
10/21/2021,431,53,484,11,27937,06/01/2023
10/22/2021,320,58,378,2,22674,06/01/2023
10/23/2021,221,39,260,4,12498,06/01/2023
10/24/2021,198,52,250,3,10343,06/01/2023
10/25/2021,410,74,484,5,28731,06/01/2023
10/26/2021,356,62,418,3,25224,06/01/2023
10/27/2021,425,52,477,3,25155,06/01/2023
10/28/2021,345,61,406,2,25632,06/01/2023
10/29/2021,369,38,407,5,21957,06/01/2023
10/30/2021,250,38,288,2,11245,06/01/2023
10/31/2021,207,46,253,2,9612,06/01/2023
11/01/2021,460,65,525,7,28070,06/01/2023
11/02/2021,413,64,477,3,24509,06/01/2023
11/03/2021,338,71,409,6,22831,06/01/2023
11/04/2021,384,42,426,4,20865,06/01/2023
11/05/2021,447,70,517,2,19987,06/01/2023
11/06/2021,289,42,331,4,9091,06/01/2023
11/07/2021,266,43,309,4,8305,06/01/2023
11/08/2021,622,99,721,5,26879,06/01/2023
11/09/2021,612,90,702,5,31325,06/01/2023
11/10/2021,624,73,697,6,25708,06/01/2023
11/11/2021,629,85,714,4,21310,06/01/2023
11/12/2021,611,101,712,5,22120,06/01/2023
11/13/2021,508,58,566,8,12566,06/01/2023
11/14/2021,430,82,512,4,11388,06/01/2023
11/15/2021,895,85,980,3,32608,06/01/2023
11/16/2021,844,125,969,8,32476,06/01/2023
11/17/2021,817,112,929,7,28284,06/01/2023
11/18/2021,945,84,1029,7,27107,06/01/2023
11/19/2021,811,106,917,0,25089,06/01/2023
11/20/2021,613,86,699,5,14481,06/01/2023
11/21/2021,503,100,603,3,13799,06/01/2023
11/22/2021,1080,137,1217,12,36203,06/01/2023
11/23/2021,1017,146,1163,9,33796,06/01/2023
11/24/2021,1062,157,1219,7,27411,06/01/2023
11/25/2021,258,82,340,6,6539,06/01/2023
11/26/2021,1022,135,1157,5,20287,06/01/2023
11/27/2021,840,120,960,8,15339,06/01/2023
11/28/2021,793,138,931,7,16387,06/01/2023
11/29/2021,2046,254,2300,5,41554,06/01/2023
11/30/2021,1878,265,2143,7,39182,06/01/2023
12/01/2021,1822,269,2091,5,34696,06/01/2023
12/02/2021,1929,242,2171,7,37537,06/01/2023
12/03/2021,1705,233,1938,4,31587,06/01/2023
12/04/2021,1189,166,1355,13,18598,06/01/2023
12/05/2021,992,159,1151,9,17595,06/01/2023
12/06/2021,2188,305,2493,10,42159,06/01/2023
12/07/2021,2063,272,2335,11,39717,06/01/2023
12/08/2021,2036,265,2301,14,36753,06/01/2023
12/09/2021,1964,291,2255,13,38215,06/01/2023
12/10/2021,1993,259,2252,10,31410,06/01/2023
12/11/2021,1139,199,1338,18,18117,06/01/2023
12/12/2021,951,203,1154,8,15718,06/01/2023
12/13/2021,2492,243,2735,13,37941,06/01/2023
12/14/2021,2572,328,2900,12,40604,06/01/2023
12/15/2021,2810,463,3273,10,40736,06/01/2023
12/16/2021,2782,349,3131,7,39528,06/01/2023
12/17/2021,2612,250,2862,19,34963,06/01/2023
12/18/2021,1814,220,2034,8,22353,06/01/2023
12/19/2021,1704,251,1955,14,21883,06/01/2023
12/20/2021,4076,492,4568,12,48981,06/01/2023
12/21/2021,4947,507,5454,12,51657,06/01/2023
12/22/2021,5519,581,6100,18,53856,06/01/2023
12/23/2021,5462,448,5910,26,46889,06/01/2023
12/24/2021,2543,455,2998,7,21023,06/01/2023
12/25/2021,1064,239,1303,17,7326,06/01/2023
12/26/2021,3278,558,3836,14,23397,06/01/2023
12/27/2021,9338,1095,10433,12,52466,06/01/2023
12/28/2021,11066,1120,12186,13,53475,06/01/2023
12/29/2021,11207,1276,12483,19,53556,06/01/2023
12/30/2021,10917,1200,12117,17,53664,06/01/2023
12/31/2021,5442,904,6346,22,26777,06/01/2023
01/01/2022,2654,479,3133,23,12294,06/01/2023
01/02/2022,5472,830,6302,24,29139,06/01/2023
01/03/2022,12927,1394,14321,27,59786,06/01/2023
01/04/2022,12555,983,13538,36,52875,06/01/2023
01/05/2022,9412,690,10102,35,42631,06/01/2023
01/06/2022,9029,976,10005,23,46445,06/01/2023
01/07/2022,4669,687,5356,31,23945,06/01/2023
01/08/2022,4518,632,5150,39,22748,06/01/2023
01/09/2022,3839,582,4421,43,21070,06/01/2023
01/10/2022,8078,1048,9126,30,47586,06/01/2023
01/11/2022,6279,780,7059,29,38958,06/01/2023
01/12/2022,6551,845,7396,35,40944,06/01/2023
01/13/2022,5798,783,6581,43,39193,06/01/2023
01/14/2022,4913,697,5610,37,32394,06/01/2023
01/15/2022,2405,414,2819,36,16626,06/01/2023
01/16/2022,2382,409,2791,56,17705,06/01/2023
01/17/2022,3449,625,4074,42,27584,06/01/2023
01/18/2022,4573,614,5187,35,39089,06/01/2023
01/19/2022,4300,497,4797,47,36700,06/01/2023
01/20/2022,3308,396,3704,42,29092,06/01/2023
01/21/2022,3048,376,3424,36,27680,06/01/2023
01/22/2022,1870,214,2084,42,15272,06/01/2023
01/23/2022,1579,268,1847,24,17272,06/01/2023
01/24/2022,2999,381,3380,28,33421,06/01/2023
01/25/2022,2585,333,2918,33,31300,06/01/2023
01/26/2022,2290,291,2581,32,28123,06/01/2023
01/27/2022,1923,236,2159,21,27038,06/01/2023
01/28/2022,1679,161,1840,24,23744,06/01/2023
01/29/2022,153,13,166,14,2696,06/01/2023
01/30/2022,906,183,1089,24,13353,06/01/2023
01/31/2022,1818,232,2050,25,28570,06/01/2023
02/01/2022,1338,201,1539,31,25904,06/01/2023
02/02/2022,1075,183,1258,28,21742,06/01/2023
02/03/2022,1034,140,1174,28,22586,06/01/2023
02/04/2022,740,109,849,17,15769,06/01/2023
02/05/2022,588,83,671,19,9349,06/01/2023
02/06/2022,470,112,582,26,9489,06/01/2023
02/07/2022,914,128,1042,21,25542,06/01/2023
02/08/2022,897,126,1023,11,25312,06/01/2023
02/09/2022,719,92,811,11,20707,06/01/2023
02/10/2022,712,85,797,17,21745,06/01/2023
02/11/2022,511,78,589,16,17690,06/01/2023
02/12/2022,338,46,384,13,8222,06/01/2023
02/13/2022,242,50,292,9,7893,06/01/2023
02/14/2022,645,103,748,13,22937,06/01/2023
02/15/2022,615,35,650,9,20901,06/01/2023
02/16/2022,548,70,618,12,19948,06/01/2023
02/17/2022,567,60,627,10,20271,06/01/2023
02/18/2022,395,48,443,11,16077,06/01/2023
02/19/2022,227,33,260,6,7583,06/01/2023
02/20/2022,252,39,291,14,7602,06/01/2023
02/21/2022,405,70,475,8,15213,06/01/2023
02/22/2022,503,54,557,8,21244,06/01/2023
02/23/2022,338,46,384,7,16713,06/01/2023
02/24/2022,404,24,428,4,18309,06/01/2023
02/25/2022,165,19,184,4,8631,06/01/2023
02/26/2022,222,37,259,6,7622,06/01/2023
02/27/2022,169,30,199,6,6802,06/01/2023
02/28/2022,356,31,387,7,18458,06/01/2023
03/01/2022,304,29,333,3,17421,06/01/2023
03/02/2022,284,32,316,3,14707,06/01/2023
03/03/2022,250,23,273,8,15082,06/01/2023
03/04/2022,241,31,272,4,13550,06/01/2023
03/05/2022,167,20,187,3,6228,06/01/2023
03/06/2022,129,35,164,1,6035,06/01/2023
03/07/2022,329,41,370,3,18002,06/01/2023
03/08/2022,270,30,300,1,16714,06/01/2023
03/09/2022,265,37,302,2,13654,06/01/2023
03/10/2022,245,41,286,4,14853,06/01/2023
03/11/2022,238,34,272,5,12727,06/01/2023
03/12/2022,156,41,197,4,6607,06/01/2023
03/13/2022,148,34,182,2,5596,06/01/2023
03/14/2022,331,57,388,2,16210,06/01/2023
03/15/2022,328,42,370,1,15042,06/01/2023
03/16/2022,316,65,381,3,13062,06/01/2023
03/17/2022,256,35,291,2,13060,06/01/2023
03/18/2022,276,50,326,0,11848,06/01/2023
03/19/2022,202,43,245,2,6348,06/01/2023
03/20/2022,202,45,247,1,5612,06/01/2023
03/21/2022,391,81,472,3,16273,06/01/2023
03/22/2022,404,57,461,1,15041,06/01/2023
03/23/2022,385,57,442,2,14120,06/01/2023
03/24/2022,344,47,391,0,12101,06/01/2023
03/25/2022,295,45,340,0,11804,06/01/2023
03/26/2022,218,50,268,1,6685,06/01/2023
03/27/2022,264,44,308,4,6253,06/01/2023
03/28/2022,501,60,561,1,16408,06/01/2023
03/29/2022,433,51,484,2,14383,06/01/2023
03/30/2022,487,71,558,0,12889,06/01/2023
03/31/2022,448,68,516,0,13944,06/01/2023
04/01/2022,404,54,458,4,11993,06/01/2023
04/02/2022,332,52,384,2,6166,06/01/2023
04/03/2022,318,59,377,2,5575,06/01/2023
04/04/2022,680,73,753,0,16613,06/01/2023
04/05/2022,616,100,716,0,16042,06/01/2023
04/06/2022,712,64,776,2,14660,06/01/2023
04/07/2022,653,85,738,4,14651,06/01/2023
04/08/2022,676,97,773,2,14031,06/01/2023
04/09/2022,435,59,494,2,6784,06/01/2023
04/10/2022,447,102,549,1,6198,06/01/2023
04/11/2022,817,122,939,3,16590,06/01/2023
04/12/2022,860,114,974,3,15385,06/01/2023
04/13/2022,889,105,994,2,13257,06/01/2023
04/14/2022,828,116,944,2,15176,06/01/2023
04/15/2022,775,97,872,1,10865,06/01/2023
04/16/2022,574,92,666,1,7332,06/01/2023
04/17/2022,303,52,355,3,3883,06/01/2023
04/18/2022,1040,160,1200,2,17192,06/01/2023
04/19/2022,916,118,1034,3,15335,06/01/2023
04/20/2022,959,120,1079,5,14037,06/01/2023
04/21/2022,850,134,984,2,13889,06/01/2023
04/22/2022,818,90,908,0,11250,06/01/2023
04/23/2022,574,88,662,0,6653,06/01/2023
04/24/2022,577,125,702,5,5898,06/01/2023
04/25/2022,1178,171,1349,3,17579,06/01/2023
04/26/2022,1124,123,1247,4,15336,06/01/2023
04/27/2022,1232,155,1387,3,14328,06/01/2023
04/28/2022,1098,171,1269,1,15282,06/01/2023
04/29/2022,1002,132,1134,6,13050,06/01/2023
04/30/2022,793,108,901,3,7121,06/01/2023
05/01/2022,778,114,892,6,6325,06/01/2023
05/02/2022,1516,208,1724,3,18404,06/01/2023
05/03/2022,1443,195,1638,3,16208,06/01/2023
05/04/2022,1550,169,1719,5,15500,06/01/2023
05/05/2022,1484,184,1668,2,16955,06/01/2023
05/06/2022,1443,154,1597,1,14211,06/01/2023
05/07/2022,1009,125,1134,5,8043,06/01/2023
05/08/2022,962,142,1104,5,6743,06/01/2023
05/09/2022,2061,207,2268,2,20984,06/01/2023
05/10/2022,1831,193,2024,5,18749,06/01/2023
05/11/2022,1910,231,2141,3,18301,06/01/2023
05/12/2022,1797,231,2028,1,18244,06/01/2023
05/13/2022,1566,218,1784,3,15239,06/01/2023
05/14/2022,1083,249,1332,2,8181,06/01/2023
05/15/2022,928,227,1155,4,7349,06/01/2023
05/16/2022,1839,323,2162,3,19121,06/01/2023
05/17/2022,1648,332,1980,4,17265,06/01/2023
05/18/2022,1643,269,1912,2,17729,06/01/2023
05/19/2022,1334,278,1612,5,16731,06/01/2023
05/20/2022,1189,229,1418,3,14247,06/01/2023
05/21/2022,770,175,945,8,7424,06/01/2023
05/22/2022,740,173,913,4,6651,06/01/2023
05/23/2022,1448,244,1692,9,17617,06/01/2023
05/24/2022,1217,189,1406,4,16294,06/01/2023
05/25/2022,1132,187,1319,4,15030,06/01/2023
05/26/2022,962,199,1161,3,13942,06/01/2023
05/27/2022,940,179,1119,2,11689,06/01/2023
05/28/2022,595,141,736,4,6060,06/01/2023
05/29/2022,557,121,678,2,5437,06/01/2023
05/30/2022,295,78,373,3,4496,06/01/2023
05/31/2022,1350,181,1531,4,18003,06/01/2023
06/01/2022,994,165,1159,5,13222,06/01/2023
06/02/2022,821,169,990,3,13442,06/01/2023
06/03/2022,674,139,813,2,11000,06/01/2023
06/04/2022,495,105,600,5,5809,06/01/2023
06/05/2022,406,99,505,1,4575,06/01/2023
06/06/2022,812,172,984,4,14845,06/01/2023
06/07/2022,725,168,893,2,12978,06/01/2023
06/08/2022,746,133,879,5,13067,06/01/2023
06/09/2022,644,100,744,4,11985,06/01/2023
06/10/2022,559,113,672,3,9763,06/01/2023
06/11/2022,356,73,429,4,5255,06/01/2023
06/12/2022,365,100,465,7,4902,06/01/2023
06/13/2022,666,150,816,2,12804,06/01/2023
06/14/2022,568,121,689,2,11414,06/01/2023
06/15/2022,591,149,740,3,10818,06/01/2023
06/16/2022,470,75,545,5,9678,06/01/2023
06/17/2022,508,92,600,5,9064,06/01/2023
06/18/2022,365,86,451,5,5307,06/01/2023
06/19/2022,347,71,418,2,4348,06/01/2023
06/20/2022,626,134,760,4,11616,06/01/2023
06/21/2022,676,116,792,4,11808,06/01/2023
06/22/2022,687,122,809,1,11639,06/01/2023
06/23/2022,621,121,742,1,10054,06/01/2023
06/24/2022,597,122,719,0,9217,06/01/2023
06/25/2022,443,101,544,4,5187,06/01/2023
06/26/2022,374,116,490,3,4691,06/01/2023
06/27/2022,756,134,890,4,11377,06/01/2023
06/28/2022,690,131,821,1,10262,06/01/2023
06/29/2022,698,157,855,7,9695,06/01/2023
06/30/2022,707,130,837,4,9435,06/01/2023
07/01/2022,521,116,637,4,7149,06/01/2023
07/02/2022,429,106,535,2,5082,06/01/2023
07/03/2022,400,110,510,4,4548,06/01/2023
07/04/2022,233,84,317,3,3322,06/01/2023
07/05/2022,954,175,1129,5,13293,06/01/2023
07/06/2022,845,171,1016,2,10597,06/01/2023
07/07/2022,664,148,812,3,10210,06/01/2023
07/08/2022,655,140,795,2,8617,06/01/2023
07/09/2022,463,131,594,4,4998,06/01/2023
07/10/2022,422,109,531,1,4516,06/01/2023
07/11/2022,767,150,917,1,11386,06/01/2023
07/12/2022,738,162,900,1,10572,06/01/2023
07/13/2022,774,155,929,3,9959,06/01/2023
07/14/2022,638,139,777,4,9643,06/01/2023
07/15/2022,573,131,704,4,8252,06/01/2023
07/16/2022,472,131,603,2,5036,06/01/2023
07/17/2022,467,132,599,2,4714,06/01/2023
07/18/2022,827,151,978,0,11526,06/01/2023
07/19/2022,809,174,983,0,11001,06/01/2023
07/20/2022,893,152,1045,1,10772,06/01/2023
07/21/2022,707,121,828,1,9442,06/01/2023
07/22/2022,736,96,832,5,8565,06/01/2023
07/23/2022,551,91,642,6,5154,06/01/2023
07/24/2022,443,76,519,3,4418,06/01/2023
07/25/2022,774,103,877,1,10223,06/01/2023
07/26/2022,864,81,945,5,9995,06/01/2023
07/27/2022,803,96,899,4,9725,06/01/2023
07/28/2022,718,83,801,4,9640,06/01/2023
07/29/2022,702,69,771,4,8341,06/01/2023
07/30/2022,490,48,538,4,4693,06/01/2023
07/31/2022,443,61,504,4,4428,06/01/2023
08/01/2022,851,140,991,6,11311,06/01/2023
08/02/2022,820,119,939,3,9330,06/01/2023
08/03/2022,804,77,881,1,10018,06/01/2023
08/04/2022,697,115,812,4,8703,06/01/2023
08/05/2022,668,93,761,3,8109,06/01/2023
08/06/2022,548,60,608,8,4983,06/01/2023
08/07/2022,467,65,532,4,4327,06/01/2023
08/08/2022,842,108,950,2,10036,06/01/2023
08/09/2022,713,116,829,3,9310,06/01/2023
08/10/2022,769,109,878,3,9275,06/01/2023
08/11/2022,701,88,789,4,9253,06/01/2023
08/12/2022,559,78,637,1,7438,06/01/2023
08/13/2022,417,48,465,5,4387,06/01/2023
08/14/2022,392,61,453,1,4027,06/01/2023
08/15/2022,672,69,741,6,10702,06/01/2023
08/16/2022,673,86,759,2,9351,06/01/2023
08/17/2022,647,73,720,1,9517,06/01/2023
08/18/2022,585,66,651,5,8039,06/01/2023
08/19/2022,501,56,557,4,6976,06/01/2023
08/20/2022,409,34,443,5,4557,06/01/2023
08/21/2022,405,39,444,1,4010,06/01/2023
08/22/2022,673,78,751,3,10111,06/01/2023
08/23/2022,582,79,661,2,8401,06/01/2023
08/24/2022,638,62,700,3,8726,06/01/2023
08/25/2022,500,64,564,5,8618,06/01/2023
08/26/2022,444,40,484,6,7023,06/01/2023
08/27/2022,342,39,381,6,4089,06/01/2023
08/28/2022,340,31,371,4,3690,06/01/2023
08/29/2022,707,77,784,1,11269,06/01/2023
08/30/2022,574,69,643,5,9742,06/01/2023
08/31/2022,601,52,653,4,9085,06/01/2023
09/01/2022,516,50,566,5,8583,06/01/2023
09/02/2022,499,66,565,3,6748,06/01/2023
09/03/2022,349,56,405,5,4245,06/01/2023
09/04/2022,337,65,402,6,3890,06/01/2023
09/05/2022,279,51,330,4,3883,06/01/2023
09/06/2022,741,133,874,2,11524,06/01/2023
09/07/2022,654,101,755,6,9264,06/01/2023
09/08/2022,573,100,673,6,9619,06/01/2023
09/09/2022,511,73,584,0,7906,06/01/2023
09/10/2022,354,71,425,4,4393,06/01/2023
09/11/2022,410,74,484,5,4214,06/01/2023
09/12/2022,750,140,890,3,11617,06/01/2023
09/13/2022,701,122,823,0,10031,06/01/2023
09/14/2022,656,97,753,5,9554,06/01/2023
09/15/2022,629,103,732,2,9639,06/01/2023
09/16/2022,590,78,668,5,8124,06/01/2023
09/17/2022,390,106,496,4,4851,06/01/2023
09/18/2022,369,113,482,4,4308,06/01/2023
09/19/2022,759,197,956,5,11505,06/01/2023
09/20/2022,697,172,869,3,10231,06/01/2023
09/21/2022,645,193,838,2,9585,06/01/2023
09/22/2022,520,133,653,3,9111,06/01/2023
09/23/2022,454,129,583,2,7696,06/01/2023
09/24/2022,382,123,505,4,4347,06/01/2023
09/25/2022,341,116,457,8,4079,06/01/2023
09/26/2022,662,175,837,7,11077,06/01/2023
09/27/2022,645,138,783,2,10488,06/01/2023
09/28/2022,618,169,787,4,9540,06/01/2023
09/29/2022,553,140,693,3,8342,06/01/2023
09/30/2022,505,143,648,5,7418,06/01/2023
10/01/2022,353,74,427,2,4511,06/01/2023
10/02/2022,290,112,402,6,3916,06/01/2023
10/03/2022,668,143,811,1,10150,06/01/2023
10/04/2022,513,147,660,1,9199,06/01/2023
10/05/2022,582,124,706,4,7642,06/01/2023
10/06/2022,573,130,703,8,7736,06/01/2023
10/07/2022,513,116,629,3,7224,06/01/2023
10/08/2022,354,113,467,4,4476,06/01/2023
10/09/2022,329,103,432,7,3688,06/01/2023
10/10/2022,509,130,639,14,8234,06/01/2023
10/11/2022,498,164,662,4,8653,06/01/2023
10/12/2022,525,153,678,5,8375,06/01/2023
10/13/2022,470,154,624,4,8210,06/01/2023
10/14/2022,401,153,554,8,6779,06/01/2023
10/15/2022,306,116,422,3,4454,06/01/2023
10/16/2022,255,122,377,5,3796,06/01/2023
10/17/2022,473,144,617,3,8577,06/01/2023
10/18/2022,460,124,584,8,7897,06/01/2023
10/19/2022,409,143,552,5,6964,06/01/2023
10/20/2022,413,123,536,7,6843,06/01/2023
10/21/2022,345,120,465,4,6400,06/01/2023
10/22/2022,241,93,334,1,4237,06/01/2023
10/23/2022,280,93,373,5,3933,06/01/2023
10/24/2022,538,131,669,4,10014,06/01/2023
10/25/2022,516,151,667,6,9641,06/01/2023
10/26/2022,495,157,652,7,8637,06/01/2023
10/27/2022,440,133,573,7,7907,06/01/2023
10/28/2022,333,97,430,7,6322,06/01/2023
10/29/2022,219,66,285,6,4061,06/01/2023
10/30/2022,193,86,279,4,3547,06/01/2023
10/31/2022,404,135,539,6,9126,06/01/2023
11/01/2022,485,124,609,6,8778,06/01/2023
11/02/2022,440,125,565,4,8698,06/01/2023
11/03/2022,410,106,516,4,8035,06/01/2023
11/04/2022,369,110,479,4,7038,06/01/2023
11/05/2022,256,92,348,6,4564,06/01/2023
11/06/2022,225,102,327,3,4178,06/01/2023
11/07/2022,457,135,592,3,9094,06/01/2023
11/08/2022,345,113,458,4,7237,06/01/2023
11/09/2022,343,96,439,1,7731,06/01/2023
11/10/2022,296,110,406,2,6348,06/01/2023
11/11/2022,312,89,401,4,5901,06/01/2023
11/12/2022,219,83,302,3,4217,06/01/2023
11/13/2022,240,81,321,4,3816,06/01/2023
11/14/2022,461,118,579,4,9405,06/01/2023
11/15/2022,399,100,499,3,7902,06/01/2023
11/16/2022,326,103,429,2,6685,06/01/2023
11/17/2022,334,91,425,3,6970,06/01/2023
11/18/2022,298,105,403,1,6369,06/01/2023
11/19/2022,209,83,292,6,4220,06/01/2023
11/20/2022,220,84,304,6,4135,06/01/2023
11/21/2022,455,115,570,5,9298,06/01/2023
11/22/2022,430,136,566,4,7377,06/01/2023
11/23/2022,426,126,552,5,6211,06/01/2023
11/24/2022,107,68,175,4,2491,06/01/2023
11/25/2022,421,130,551,3,6136,06/01/2023
11/26/2022,359,106,465,7,5218,06/01/2023
11/27/2022,354,120,474,4,5048,06/01/2023
11/28/2022,785,155,940,7,11964,06/01/2023
11/29/2022,664,159,823,2,10563,06/01/2023
11/30/2022,591,138,729,2,8398,06/01/2023
12/01/2022,556,116,672,4,8643,06/01/2023
12/02/2022,525,106,631,1,7283,06/01/2023
12/03/2022,342,87,429,9,4428,06/01/2023
12/04/2022,333,94,427,4,4353,06/01/2023
12/05/2022,681,144,825,7,10574,06/01/2023
12/06/2022,623,137,760,5,8049,06/01/2023
12/07/2022,655,101,756,5,7716,06/01/2023
12/08/2022,578,135,713,7,7166,06/01/2023
12/09/2022,595,141,736,4,7250,06/01/2023
12/10/2022,347,101,448,3,4134,06/01/2023
12/11/2022,365,121,486,3,4110,06/01/2023
12/12/2022,700,162,862,6,9162,06/01/2023
12/13/2022,706,164,870,4,8896,06/01/2023
12/14/2022,694,109,803,5,7328,06/01/2023
12/15/2022,575,161,736,9,7532,06/01/2023
12/16/2022,556,158,714,4,6736,06/01/2023
12/17/2022,409,136,545,11,4420,06/01/2023
12/18/2022,429,168,597,7,4175,06/01/2023
12/19/2022,722,192,914,10,9418,06/01/2023
12/20/2022,851,186,1037,5,10138,06/01/2023
12/21/2022,721,101,822,11,6879,06/01/2023
12/22/2022,636,173,809,6,6531,06/01/2023
12/23/2022,592,161,753,5,5343,06/01/2023
12/24/2022,361,132,493,7,3248,06/01/2023
12/25/2022,247,74,321,3,2211,06/01/2023
12/26/2022,622,215,837,10,5261,06/01/2023
12/27/2022,884,206,1090,11,8444,06/01/2023
12/28/2022,898,220,1118,3,7837,06/01/2023
12/29/2022,772,169,941,14,6959,06/01/2023
12/30/2022,754,257,1011,11,6153,06/01/2023
12/31/2022,470,142,612,7,4067,06/01/2023
01/01/2023,287,118,405,9,2638,06/01/2023
01/02/2023,654,172,826,6,5558,06/01/2023
01/03/2023,760,223,983,4,7777,06/01/2023
01/04/2023,768,179,947,8,6775,06/01/2023
01/05/2023,674,182,856,9,7439,06/01/2023
01/06/2023,577,145,722,6,6140,06/01/2023
01/07/2023,357,126,483,4,3857,06/01/2023
01/08/2023,318,128,446,6,3639,06/01/2023
01/09/2023,636,149,785,8,7171,06/01/2023
01/10/2023,517,130,647,11,6966,06/01/2023
01/11/2023,552,127,679,4,6921,06/01/2023
01/12/2023,496,119,615,4,6221,06/01/2023
01/13/2023,463,110,573,8,5276,06/01/2023
01/14/2023,317,80,397,0,3472,06/01/2023
01/15/2023,261,76,337,8,3243,06/01/2023
01/16/2023,416,87,503,8,5294,06/01/2023
01/17/2023,454,106,560,7,7893,06/01/2023
01/18/2023,509,121,630,8,7082,06/01/2023
01/19/2023,411,82,493,9,6709,06/01/2023
01/20/2023,376,97,473,7,6467,06/01/2023
01/21/2023,248,65,313,7,3565,06/01/2023
01/22/2023,235,78,313,3,3208,06/01/2023
01/23/2023,428,112,540,7,7118,06/01/2023
01/24/2023,437,86,523,2,6669,06/01/2023
01/25/2023,396,86,482,8,5990,06/01/2023
01/26/2023,361,86,447,8,5828,06/01/2023
01/27/2023,353,77,430,6,5167,06/01/2023
01/28/2023,240,62,302,11,3354,06/01/2023
01/29/2023,215,75,290,9,3066,06/01/2023
01/30/2023,405,87,492,5,7514,06/01/2023
01/31/2023,317,107,424,3,6922,06/01/2023
02/01/2023,375,82,457,5,6743,06/01/2023
02/02/2023,315,64,379,3,6037,06/01/2023
02/03/2023,252,65,317,7,4690,06/01/2023
02/04/2023,167,39,206,7,2840,06/01/2023
02/05/2023,185,60,245,6,3066,06/01/2023
02/06/2023,405,61,466,4,6746,06/01/2023
02/07/2023,288,65,353,5,5873,06/01/2023
02/08/2023,298,58,356,3,6252,06/01/2023
02/09/2023,255,67,322,3,5391,06/01/2023
02/10/2023,242,59,301,1,4847,06/01/2023
02/11/2023,178,40,218,3,3083,06/01/2023
02/12/2023,141,58,199,3,2682,06/01/2023
02/13/2023,280,76,356,8,6092,06/01/2023
02/14/2023,242,59,301,4,5696,06/01/2023
02/15/2023,257,80,337,6,5202,06/01/2023
02/16/2023,208,59,267,5,6357,06/01/2023
02/17/2023,194,48,242,1,4719,06/01/2023
02/18/2023,135,30,165,3,2936,06/01/2023
02/19/2023,141,43,184,4,2488,06/01/2023
02/20/2023,214,52,266,3,4916,06/01/2023
02/21/2023,218,59,277,3,5366,06/01/2023
02/22/2023,224,50,274,5,4627,06/01/2023
02/23/2023,182,38,220,2,5081,06/01/2023
02/24/2023,174,38,212,3,4397,06/01/2023
02/25/2023,111,41,152,3,2648,06/01/2023
02/26/2023,113,36,149,3,2650,06/01/2023
02/27/2023,219,39,258,4,6617,06/01/2023
02/28/2023,98,30,128,5,3595,06/01/2023
03/01/2023,206,50,256,2,5298,06/01/2023
03/02/2023,122,40,162,3,4169,06/01/2023
03/03/2023,126,32,158,3,4027,06/01/2023
03/04/2023,94,35,129,2,2578,06/01/2023
03/05/2023,106,19,125,2,2511,06/01/2023
03/06/2023,126,31,157,1,5774,06/01/2023
03/07/2023,129,34,163,1,5106,06/01/2023
03/08/2023,155,41,196,2,4925,06/01/2023
03/09/2023,105,31,136,2,4018,06/01/2023
03/10/2023,118,35,153,7,3643,06/01/2023
03/11/2023,61,13,74,2,2119,06/01/2023
03/12/2023,50,25,75,4,1901,06/01/2023
03/13/2023,136,36,172,2,4266,06/01/2023
03/14/2023,99,26,125,3,4043,06/01/2023
03/15/2023,119,45,164,3,4091,06/01/2023
03/16/2023,111,34,145,3,3455,06/01/2023
03/17/2023,90,28,118,2,3192,06/01/2023
03/18/2023,63,21,84,2,1998,06/01/2023
03/19/2023,71,14,85,1,1886,06/01/2023
03/20/2023,112,44,156,3,4538,06/01/2023
03/21/2023,78,31,109,1,3395,06/01/2023
03/22/2023,102,29,131,4,3843,06/01/2023
03/23/2023,99,27,126,3,3329,06/01/2023
03/24/2023,79,32,111,1,3266,06/01/2023
03/25/2023,71,26,97,2,1872,06/01/2023
03/26/2023,48,24,72,4,1809,06/01/2023
03/27/2023,104,36,140,3,4012,06/01/2023
03/28/2023,87,32,119,1,3271,06/01/2023
03/29/2023,78,24,102,0,4113,06/01/2023
03/30/2023,65,32,97,1,3193,06/01/2023
03/31/2023,56,25,81,1,3091,06/01/2023
04/01/2023,39,23,62,1,1690,06/01/2023
04/02/2023,45,25,70,2,1666,06/01/2023
04/03/2023,108,37,145,3,3940,06/01/2023
04/04/2023,79,41,120,1,3111,06/01/2023
04/05/2023,68,30,98,3,3095,06/01/2023
04/06/2023,56,36,92,0,3047,06/01/2023
04/07/2023,70,30,100,0,2477,06/01/2023
04/08/2023,35,24,59,1,1571,06/01/2023
04/09/2023,27,5,32,1,1345,06/01/2023
04/10/2023,79,21,100,1,3267,06/01/2023
04/11/2023,65,15,80,0,2662,06/01/2023
04/12/2023,59,20,79,1,2734,06/01/2023
04/13/2023,57,30,87,1,2603,06/01/2023
04/14/2023,53,19,72,0,2590,06/01/2023
04/15/2023,33,14,47,0,1513,06/01/2023
04/16/2023,46,8,54,0,1516,06/01/2023
04/17/2023,57,33,90,0,3008,06/01/2023
04/18/2023,51,20,71,0,2621,06/01/2023
04/19/2023,36,18,54,3,2427,06/01/2023
04/20/2023,49,15,64,1,2366,06/01/2023
04/21/2023,39,14,53,4,2397,06/01/2023
04/22/2023,39,10,49,2,1338,06/01/2023
04/23/2023,24,13,37,2,1288,06/01/2023
04/24/2023,56,31,87,4,2852,06/01/2023
04/25/2023,56,29,85,0,2486,06/01/2023
04/26/2023,48,22,70,1,2154,06/01/2023
04/27/2023,50,22,72,0,2306,06/01/2023
04/28/2023,40,18,58,0,2290,06/01/2023
04/29/2023,30,12,42,0,1176,06/01/2023
04/30/2023,25,13,38,0,1207,06/01/2023
05/01/2023,75,15,90,0,2450,06/01/2023
05/02/2023,50,23,73,0,1978,06/01/2023
05/03/2023,52,12,64,0,1951,06/01/2023
05/04/2023,43,10,53,0,1848,06/01/2023
05/05/2023,41,20,61,1,1712,06/01/2023
05/06/2023,32,15,47,0,997,06/01/2023
05/07/2023,26,17,43,1,948,06/01/2023
05/08/2023,49,37,86,1,2024,06/01/2023
05/09/2023,47,16,63,1,1437,06/01/2023
05/10/2023,53,24,77,0,1451,06/01/2023
05/11/2023,45,16,61,0,1174,06/01/2023
05/12/2023,43,17,60,0,927,06/01/2023
05/13/2023,31,14,45,1,568,06/01/2023
05/14/2023,12,13,25,1,455,06/01/2023
05/15/2023,38,27,65,0,774,06/01/2023
05/16/2023,36,16,52,0,813,06/01/2023
05/17/2023,38,11,49,0,737,06/01/2023
05/18/2023,44,9,53,0,669,06/01/2023
05/19/2023,32,19,51,1,621,06/01/2023
05/20/2023,16,13,29,0,421,06/01/2023
05/21/2023,22,24,46,1,476,06/01/2023
05/22/2023,45,30,75,0,875,06/01/2023
05/23/2023,45,16,61,2,708,06/01/2023
05/24/2023,36,23,59,0,678,06/01/2023
05/25/2023,35,27,62,0,684,06/01/2023
05/26/2023,36,14,50,2,587,06/01/2023
05/27/2023,20,12,32,0,427,06/01/2023
05/28/2023,24,15,39,0,398,06/01/2023
05/29/2023,18,18,36,0,388,06/01/2023
05/30/2023,31,21,52,0,463,06/01/2023
05/31/2023,9,0,9,0,209,06/01/2023
